r,w,d,h
0,6.5,14,3
1,3,4,3
2,3,4,3
s1,3,4,3
3,3,4,3
4,3,4,3
5,3,4,3
6,3,4,3
7,3,4,3
8,3,4,3
9,3,4,3
10,3,4,3
11,3,4,3
12,3,4,3
13,3,4,3
14,3,4,3
15,3,4,3
16,3,4,3
17,3,4,3
18,3,4,3
19,3,4,3
20,3,4,3
21,3,4,3
22,3,4,3
23,3,4,3
24,3,4,3
25,3,4,3
26,3,4,3
27,3,4,3
28,3,4,3
29,3,4,3
30,3,4,3
31,3,4,3
32,3,4,3
33,3,4,3
34,3,4,3
35,3,4,3
36,3,4,3
37,3,4,3
38,3,4,3
39,3,4,3
s2,3,4,3
40,3,4,3
41,3,4,3
42,3,4,3